db/bluetooth/status	tizen::vconf::public::r::platform::rw
db/browser/user_agent	tizen::vconf::public::r::platform::rw
db/ciss/sim1_number	tizen::vconf::platform::rw
db/ciss/sim2_number	tizen::vconf::platform::rw
db/ciss/video_image_path2	tizen::vconf::platform::rw
db/email_handle/active_sync_handle	tizen::vconf::platform::rw
db/bluetooth/status	tizen::vconf::public::r::platform::rw
db/browser/user_agent	tizen::vconf::public::r::platform::rw
db/ciss/sim1_number	tizen::vconf::platform::rw
db/ciss/sim2_number	tizen::vconf::platform::rw
db/ciss/video_image_path2	tizen::vconf::platform::rw
db/email_handle/active_sync_handle	tizen::vconf::platform::rw
db/isf/csc_initial_uuid	tizen::vconf::setting::admin
db/location/replay/ManualHAccuracy	tizen::vconf::public::r::platform::rw
db/location/setting/GpsPopup	tizen::vconf::network
db/lockscreen/cp_changecategorypopup_donotshowagain	tizen::vconf::platform::rw
db/lockscreen/cp_first_set	tizen::vconf::platform::rw
db/lockscreen/cp_setpopup_donotshowagain	tizen::vconf::platform::rw
db/lockscreen/cp_wifipopup_donotshowagain	tizen::vconf::platform::rw
db/lockscreen/enter_password_after_swifing	tizen::vconf::platform::rw
db/lockscreen/home_wallpaper_is_default	tizen::vconf::platform::rw
db/lockscreen/pedometer_display	tizen::vconf::platform::rw
db/lockscreen/pre_bgset	tizen::vconf::platform::rw
db/lockscreen/pre_wallpaper_type	tizen::vconf::platform::rw
db/lockscreen/wallpaper_count	tizen::vconf::platform::rw
db/lockscreen/weather_display	tizen::vconf::platform::rw
db/private/deviced/lcd_brightness_init	tizen::vconf::platform::r
db/private/email-service/default_account_id	tizen::vconf::platform::rw
db/private/email-service/latest_mail_id	tizen::vconf::platform::rw
db/private/email-service/noti_badge_ticker	tizen::vconf::platform::rw
db/private/email-service/noti_display_content_ticker	tizen::vconf::platform::rw
db/private/email-service/noti_notification_ticker	tizen::vconf::platform::rw
db/private/email-service/noti_private_id/1	tizen::vconf::platform::rw
db/private/email-service/noti_private_id/10	tizen::vconf::platform::rw
db/private/email-service/noti_private_id/2	tizen::vconf::platform::rw
db/private/email-service/noti_private_id/3	tizen::vconf::platform::rw
db/private/email-service/noti_private_id/4	tizen::vconf::platform::rw
db/private/email-service/noti_private_id/5	tizen::vconf::platform::rw
db/private/email-service/noti_private_id/6	tizen::vconf::platform::rw
db/private/email-service/noti_private_id/7	tizen::vconf::platform::rw
db/private/email-service/noti_private_id/8	tizen::vconf::platform::rw
db/private/email-service/noti_private_id/9	tizen::vconf::platform::rw
db/private/email-service/noti_rep_type	tizen::vconf::platform::rw
db/private/email-service/noti_ringtone_path	tizen::vconf::platform::rw
db/private/email-service/noti_use_default_ringtone	tizen::vconf::platform::rw
db/private/email-service/noti_vibration_status	tizen::vconf::platform::rw
db/private/email-service/noti_vip_use_default_ringtone	tizen::vconf::platform::rw
db/private/email-service/noti_vip_vibration_status	tizen::vconf::platform::rw
db/private/email-service/slot_size	tizen::vconf::platform::rw
db/private/libug-setting-mobileap-efl/prev_wifi_status	tizen::vconf::platform::rw
db/private/mediaserver/mmc_info	tizen::vconf::platform::rw
db/private/msg-service/cb_msg/language/0	tizen::vconf::platform::rw
db/private/msg-service/cb_msg/language/1	tizen::vconf::platform::rw
db/private/msg-service/cb_msg/language/2	tizen::vconf::platform::rw
db/private/msg-service/cb_msg/language/3	tizen::vconf::platform::rw
db/private/msg-service/cb_msg/language/4	tizen::vconf::platform::rw
db/private/msg-service/cb_msg/language/5	tizen::vconf::platform::rw
db/private/msg-service/cb_msg/language/6	tizen::vconf::platform::rw
db/private/msg-service/cb_msg/language/7	tizen::vconf::platform::rw
db/private/msg-service/cb_msg/language/8	tizen::vconf::platform::rw
db/private/msg-service/cb_msg/language/9	tizen::vconf::platform::rw
db/private/msg-service/cb_msg/max_sim_count/1	tizen::vconf::platform::rw
db/private/msg-service/cb_msg/max_sim_count/2	tizen::vconf::platform::rw
db/private/msg-service/cb_msg/max_sim_count/3	tizen::vconf::platform::rw
db/private/msg-service/cb_msg/receive/1	tizen::vconf::platform::rw
db/private/msg-service/cb_msg/receive/2	tizen::vconf::platform::rw
db/private/msg-service/cb_msg/save	tizen::vconf::platform::rw
db/private/msg-service/cb_noti_priv_id	tizen::vconf::platform::rw
db/private/msg-service/emergency_noti_id	tizen::vconf::platform::rw
db/private/msg-service/general/alert_rep_type	tizen::vconf::platform::rw
db/private/msg-service/general/auto_erase	tizen::vconf::platform::rw
db/private/msg-service/general/block_msg	tizen::vconf::platform::rw
db/private/msg-service/general/block_unknown_msg	tizen::vconf::platform::rw
db/private/msg-service/general/contact_sync_time	tizen::vconf::platform::rw
db/private/msg-service/general/keep_copy	tizen::vconf::platform::rw
db/private/msg-service/general/max_recipient	tizen::vconf::platform::rw
db/private/msg-service/general/mms_limit	tizen::vconf::platform::rw
db/private/msg-service/general/msg_id_counter	tizen::vconf::platform::rw
db/private/msg-service/general/notification	tizen::vconf::platform::rw
db/private/msg-service/general/page_limit	tizen::vconf::platform::rw
db/private/msg-service/general/preview	tizen::vconf::platform::rw
db/private/msg-service/general/ringtone_path	tizen::vconf::platform::rw
db/private/msg-service/general/ringtone_type	tizen::vconf::platform::rw
db/private/msg-service/general/search_tags	tizen::vconf::platform::rw
db/private/msg-service/general/sms_limit	tizen::vconf::platform::rw
db/private/msg-service/general/sms_mms_threshold	tizen::vconf::platform::rw
db/private/msg-service/general/sms_storage	tizen::vconf::platform::rw
db/private/msg-service/general/ua_profile	tizen::vconf::platform::rw
db/private/msg-service/general/vibration	tizen::vconf::platform::rw
db/private/msg-service/mms_recv/abroad_network	tizen::vconf::platform::rw
db/private/msg-service/mms_recv/delivery_receipt	tizen::vconf::platform::rw
db/private/msg-service/mms_recv/home_network	tizen::vconf::platform::rw
db/private/msg-service/mms_recv/read_receipt	tizen::vconf::platform::rw
db/private/msg-service/mms_recv/reject_advertisement	tizen::vconf::platform::rw
db/private/msg-service/mms_recv/reject_unknown	tizen::vconf::platform::rw
db/private/msg-service/mms_send/body_replying	tizen::vconf::platform::rw
db/private/msg-service/mms_send/creation_mode	tizen::vconf::platform::rw
db/private/msg-service/mms_send/custom_delivery	tizen::vconf::platform::rw
db/private/msg-service/mms_send/delivery_report	tizen::vconf::platform::rw
db/private/msg-service/mms_send/delivery_time	tizen::vconf::platform::rw
db/private/msg-service/mms_send/expiry_time	tizen::vconf::platform::rw
db/private/msg-service/mms_send/hide_recipients	tizen::vconf::platform::rw
db/private/msg-service/mms_send/keep_copy	tizen::vconf::platform::rw
db/private/msg-service/mms_send/msg_class	tizen::vconf::platform::rw
db/private/msg-service/mms_send/priority	tizen::vconf::platform::rw
db/private/msg-service/mms_send/read_reply	tizen::vconf::platform::rw
db/private/msg-service/mms_send/reply_charging	tizen::vconf::platform::rw
db/private/msg-service/mms_send/reply_charging_deadline	tizen::vconf::platform::rw
db/private/msg-service/mms_send/reply_charging_size	tizen::vconf::platform::rw
db/private/msg-service/mms_send/report_allowed	tizen::vconf::platform::rw
db/private/msg-service/mms_send/sender_visibility	tizen::vconf::platform::rw
db/private/msg-service/mms_style/bg_color/blue	tizen::vconf::platform::rw
db/private/msg-service/mms_style/bg_color/green	tizen::vconf::platform::rw
db/private/msg-service/mms_style/bg_color/hue	tizen::vconf::platform::rw
db/private/msg-service/mms_style/bg_color/red	tizen::vconf::platform::rw
db/private/msg-service/mms_style/font_color/blue	tizen::vconf::platform::rw
db/private/msg-service/mms_style/font_color/green	tizen::vconf::platform::rw
db/private/msg-service/mms_style/font_color/hue	tizen::vconf::platform::rw
db/private/msg-service/mms_style/font_color/red	tizen::vconf::platform::rw
db/private/msg-service/mms_style/font_size	tizen::vconf::platform::rw
db/private/msg-service/mms_style/font_style/bold	tizen::vconf::platform::rw
db/private/msg-service/mms_style/font_style/italic	tizen::vconf::platform::rw
db/private/msg-service/mms_style/font_style/underline	tizen::vconf::platform::rw
db/private/msg-service/mms_style/page_custom_dur	tizen::vconf::platform::rw
db/private/msg-service/mms_style/page_dur	tizen::vconf::platform::rw
db/private/msg-service/mms_style/page_dur_manual	tizen::vconf::platform::rw
db/private/msg-service/notification_priv_id	tizen::vconf::platform::rw
db/private/msg-service/push_msg/recv_option	tizen::vconf::platform::rw
db/private/msg-service/push_msg/service_load	tizen::vconf::platform::rw
db/private/msg-service/sentfail_noti_id	tizen::vconf::platform::rw
db/private/msg-service/sim_count/total_cnt/1	tizen::vconf::platform::rw
db/private/msg-service/sim_count/total_cnt/2	tizen::vconf::platform::rw
db/private/msg-service/sim_count/total_cnt/3	tizen::vconf::platform::rw
db/private/msg-service/sim_count/used_cnt/1	tizen::vconf::platform::rw
db/private/msg-service/sim_count/used_cnt/2	tizen::vconf::platform::rw
db/private/msg-service/sim_count/used_cnt/3	tizen::vconf::platform::rw
db/private/msg-service/sim_full_noti_id	tizen::vconf::platform::rw
db/private/msg-service/sim_msg_noti_priv_id	tizen::vconf::platform::rw
db/private/msg-service/size_opt/msg_size	tizen::vconf::platform::rw
db/private/msg-service/sms_send/dcs	tizen::vconf::platform::rw
db/private/msg-service/sms_send/delivery_report	tizen::vconf::platform::rw
db/private/msg-service/sms_send/reply_path	tizen::vconf::platform::rw
db/private/msg-service/sms_send/save_storage	tizen::vconf::platform::rw
db/private/msg-service/voice_mail/voice_mail_alphaid/1	tizen::vconf::platform::rw
db/private/msg-service/voice_mail/voice_mail_alphaid/2	tizen::vconf::platform::rw
db/private/msg-service/voice_mail/voice_mail_alphaid/3	tizen::vconf::platform::rw
db/private/msg-service/voice_mail/voice_mail_count/1	tizen::vconf::platform::rw
db/private/msg-service/voice_mail/voice_mail_count/2	tizen::vconf::platform::rw
db/private/msg-service/voice_mail/voice_mail_count/3	tizen::vconf::platform::rw
db/private/msg-service/voice_mail/voice_mail_number/1	tizen::vconf::platform::rw
db/private/msg-service/voice_mail/voice_mail_number/2	tizen::vconf::platform::rw
db/private/msg-service/voice_mail/voice_mail_number/3	tizen::vconf::platform::rw
db/private/rpm-installer/requestinfo/command	tizen::vconf::platform::rw
db/private/rpm-installer/requestinfo/options	tizen::vconf::platform::rw
db/private/rpm-installer/requestinfo/pkgname	tizen::vconf::platform::rw
db/private/rpm-installer/state	tizen::vconf::platform::rw
db/private/rpm-installer/stateinfo	tizen::vconf::platform::rw
db/private/sysman/cool_down_mode	tizen::vconf::platform::rw
db/private/sysman/enhance_mode	tizen::vconf::platform::r
db/private/sysman/enhance_scenario	tizen::vconf::platform::r
db/private/sysman/mmc_device_id	tizen::vconf::platform::r
db/private/usb/usb_control	tizen::vconf::platform::r
db/setting/effect_image	tizen::vconf::platform::rw
db/starter/missed_call	tizen::vconf::setting::admin
db/starter/unread_message	tizen::vconf::setting::admin
file/private/bt-core/flight_mode_deactivated	tizen::vconf::platform::rw
file/private/bt-core/powersaving_mode_deactivated	tizen::vconf::platform::rw
file/private/bt-service/bt_off_due_to_timeout	tizen::vconf::platform::rw
file/private/contacts-service/default_lang	tizen::vconf::platform::rw
file/private/isf/autocapital_allow	tizen::vconf::public::rw
file/private/isf/autoperiod_allow	tizen::vconf::public::rw
file/private/libug-setting-bluetooth-efl/visibility_time	tizen::vconf::platform::rw
file/private/libug-setting-mobileap-efl/bt_popup_check_box_status	tizen::vconf::platform::rw
file/private/libug-setting-mobileap-efl/usb_popup_check_box_status	tizen::vconf::platform::rw
file/private/libug-setting-mobileap-efl/wifi_popup_check_box_status	tizen::vconf::platform::rw
file/private/lockscreen/bt_in	tizen::vconf::platform::rw
file/private/lockscreen/bt_out	tizen::vconf::platform::rw
file/private/lockscreen/default_pkgname	tizen::vconf::platform::rw
file/private/lockscreen/pkgname	tizen::vconf::platform::rw
file/private/sound/volume/balance	tizen::vconf::volume::set
file/private/wifi/last_power_state	tizen::vconf::platform::r
file/private/wifi/network_bonding	tizen::vconf::setting::admin
file/private/wifi/sleep_policy	tizen::vconf::setting::admin
file/private/wifi/sort_by	tizen::vconf::setting::admin
file/private/wifi/wifi_off_by_airplane	tizen::vconf::platform::r
file/private/wifi/wifi_off_by_emergency	tizen::vconf::platform::r
file/private/wifi/wifi_off_by_restricted	tizen::vconf::platform::r
memory/bluetooth/device	tizen::vconf::platform::rw
memory/call/ui_state	tizen::vconf::platform::rw
memory/call/ui_visibility	tizen::vconf::platform::rw
memory/factory/loopback	tizen::vconf::platform::rw
memory/homescreen/ignore-resume	tizen::vconf::platform::rw
memory/idle_lock/state	tizen::vconf::platform::rw
memory/idle-screen/focused_package	tizen::vconf::platform::rw
memory/private/mobileap-agent/ssid	tizen::vconf::tethering::admin
memory/private/msg-service/default_network_sim	tizen::vconf::platform::rw
memory/private/msg-service/iccid/1	tizen::vconf::platform::rw
memory/private/msg-service/iccid/2	tizen::vconf::platform::rw
memory/private/msg-service/iccid/3	tizen::vconf::platform::rw
memory/private/msg-service/msisdn/1	tizen::vconf::platform::rw
memory/private/msg-service/msisdn/2	tizen::vconf::platform::rw
memory/private/msg-service/msisdn/3	tizen::vconf::platform::rw
memory/private/msg-service/national_sim/1	tizen::vconf::platform::rw
memory/private/msg-service/national_sim/2	tizen::vconf::platform::rw
memory/private/msg-service/national_sim/3	tizen::vconf::platform::rw
memory/private/msg-service/sim_changed/1	tizen::vconf::platform::rw
memory/private/msg-service/sim_changed/2	tizen::vconf::platform::rw
memory/private/msg-service/sim_changed/3	tizen::vconf::platform::rw
memory/private/msg-service/sim_mo_ctrl/1	tizen::vconf::platform::rw
memory/private/msg-service/sim_mo_ctrl/2	tizen::vconf::platform::rw
memory/private/msg-service/sim_mo_ctrl/3	tizen::vconf::platform::rw
memory/private/msg-service/sim_st/1	tizen::vconf::platform::rw
memory/private/msg-service/sim_st/2	tizen::vconf::platform::rw
memory/private/msg-service/sim_st/3	tizen::vconf::platform::rw
memory/private/msg-service/sim_subs_id/1	tizen::vconf::platform::rw
memory/private/msg-service/sim_subs_id/2	tizen::vconf::platform::rw
memory/private/msg-service/sim_subs_id/3	tizen::vconf::platform::rw
memory/private/Sound/ASMReady	tizen::vconf::platform::rw
memory/private/sound/hdmisupport	tizen::vconf::platform::rw
memory/private/sound/pcm_dump	tizen::vconf::public::r::platform::rw
memory/private/sound/PrimaryVolumetype	tizen::vconf::public::r::platform::rw
memory/private/sound/PrimaryVolumetypeForce	tizen::vconf::public::rw
memory/private/telephony/modem_state	tizen::vconf::telephony::admin
memory/private/wifi_direct_manager/dhcp_ip_lease	tizen::vconf::platform::rw
memory/private/wifi_direct_manager/dhcpc_server_ip	tizen::vconf::platform::r
memory/private/wifi_direct_manager/p2p_gateway	tizen::vconf::platform::r
memory/private/wifi_direct_manager/p2p_ifname	tizen::vconf::platform::r
memory/private/wifi_direct_manager/p2p_local_ip	tizen::vconf::platform::r
memory/private/wifi_direct_manager/p2p_subnet_mask	tizen::vconf::platform::r
memory/sysman/cradle_status	tizen::vconf::public::r
memory/wifi_direct/state	tizen::vconf::network
